"id","player","account_name","week","day","win_loss","rb","bonus","daily_rb","result_day","working_time","reserv_wallet","fk_user_data_balance"
1,"Igor","nmccj02",0,"2024-01-05","-24095",70,"4452","51940","27845",NULL,"47488","1"
2,"Igor","nmccj02",0,"2024-01-06","211307",70,"4774","55697","267004",NULL,"50923","2"
3,"Igor","nmccj01",0,"2024-01-05","-47530",70,"4996","58287","10757",NULL,"53291","3"
4,"Igor","nmccj01",0,"2024-01-06","77118",70,"4655","54308","131426",NULL,"49653","4"
5,"Igor","nmccj03",0,"2024-01-05","0",70,"0","0","0",NULL,"0","5"
6,"Igor","nmccj03",0,"2024-01-06","0",70,"0","0","0",NULL,"0","6"
7,"Igor","nmccj02",1,"2024-01-07","-277467",70,"5779","67422","-210045",NULL,"61643","7"
8,"Igor","nmccj01",1,"2024-01-07","-200561",70,"5628","65660","-134901",NULL,"60032","8"
9,"Igor","nmccj03",1,"2024-01-07","0",70,"0","0","0",NULL,"0","9"
10,"Igor","nmccj02",1,"2024-01-08","-207698",70,"6764","78913","-128785",NULL,"72149","10"
11,"Igor","nmccj01",1,"2024-01-08","-254601",70,"6292","73407","-181194",NULL,"67115","11"
12,"Igor","nmccj02",1,"2024-01-09","93395",70,"2657","30998","124393",NULL,"28341","12"
13,"Igor","nmccj01",1,"2024-01-09","-332375",70,"2725","31792","-300583",NULL,"29067","13"
14,"Igor","nmccj02",1,"2024-01-13","15665",70,"2608","30427","46092",NULL,"27819","14"
15,"Igor","nmccj01",1,"2024-01-13","44128",70,"2075","24208","68336",NULL,"22133","15"
16,"Igor","nmccj02",2,"2024-01-14","-172454",70,"6995","81608","-90846",NULL,"74613","16"
17,"Igor","nmccj01",2,"2024-01-14","321010",70,"3967","46282","367292",NULL,"42315","17"
18,"Igor","nmccj02",2,"2024-01-15","219220",70,"4356","50820","270040",NULL,"46464","18"
19,"Igor","nmccj01",2,"2024-01-15","263574",70,"3945","46025","309599",NULL,"42080","19"
20,"Igor","nmccj02",2,"2024-01-16","248819",70,"7205","84058","332877",NULL,"76853","20"
21,"Igor","nmccj01",2,"2024-01-16","-72890",70,"5104","59547","-13343",NULL,"54443","21"
22,"Igor","nmccj02",2,"2024-01-17","41001",70,"2581","30112","71113",NULL,"27531","22"
23,"Igor","nmccj01",2,"2024-01-17","-95187",70,"3421","39912","-55275",NULL,"36491","23"
24,"Igor","nmccj02",2,"2024-01-18","-190825",70,"5694","66430","-124395",NULL,"60736","24"
25,"Igor","nmccj01",2,"2024-01-18","-183641",70,"5807","67748","-115893",NULL,"61941","25"
26,"Igor","nmccj01",3,"2024-01-21","38343",70,"870","10150","48493",NULL,"9280","26"
27,"Igor","nmccj02",3,"2024-01-21","58245",70,"884","10313","68558",NULL,"9429","27"
28,"Igor","nmccj01",3,"2024-01-22","-433343",70,"6639","77455","-355888",NULL,"70816","28"
29,"Igor","nmccj02",3,"2024-01-22","99539",70,"6267","73115","172654",NULL,"66848","29"
32,"Igor","nmccj01",3,"2024-01-23","-54186",70,"5723","66768","12582",NULL,"61045","32"
37,"Igor","nmccj02",3,"2024-01-23","-37213",70,"4232","49373","12160",NULL,"45141","37"
38,"Igor","nmccj03",3,"2024-01-23","401541",70,"5151","60095","461636",NULL,"54944","38"
39,"Igor","nmccj01",3,"2024-01-24","-131456",70,"4688","54693","-76763",NULL,"50005","39"
40,"Igor","nmccj02",3,"2024-01-24","93092",70,"4576","53387","146479",NULL,"48811","40"
41,"Igor","nmccj03",3,"2024-01-24","-7312",70,"3689","43038","35726",NULL,"39349","41"
42,"Igor","nmccj01",3,"2024-01-25","198918",70,"2929","34172","233090",NULL,"31243","42"
43,"Igor","nmccj02",3,"2024-01-25","223269",70,"3847","44882","268151",NULL,"41035","43"
44,"Igor","nmccj03",3,"2024-01-25","6487",70,"2893","33752","40239",NULL,"30859","44"
45,"Igor","nmccj01",3,"2024-01-26","181108",70,"4488","52360","233468",NULL,"47872","45"
46,"Igor","nmccj02",3,"2024-01-26","-337879",70,"5121","59745","-278134",NULL,"54624","46"
47,"Igor","nmccj03",3,"2024-01-26","-191465",70,"3651","42595","-148870",NULL,"38944","47"
48,"Igor","nmccj01",3,"2024-01-27","-60413",70,"889","10372","-50041",NULL,"9483","48"
49,"Igor","nmccj02",3,"2024-01-27","139055",70,"1545","18025","157080",NULL,"16480","49"
50,"Igor","nmccj03",3,"2024-01-27","57516",70,"1006","11737","69253",NULL,"10731","50"
51,"Igor","nmccj01",4,"2024-01-29","20809",70,"5953","69452","90261",NULL,"63499","51"
52,"Igor","nmccj02",4,"2024-01-29","372833",70,"5649","65905","438738",NULL,"60256","52"
53,"Igor","nmccj03",4,"2024-01-29","60096",70,"3990","46550","106646",NULL,"42560","53"
54,"Igor","nmccj01",4,"2024-01-30","146585",70,"2363","27568","174153",NULL,"25205","54"
55,"Igor","nmccj02",4,"2024-01-30","86277",70,"1796","20953","107230",NULL,"19157","55"
56,"Igor","nmccj03",4,"2024-01-30","22353",70,"1430","16683","39036",NULL,"15253","56"
57,"Igor","nmccj01",4,"2024-01-31","-37721",70,"0","0","-37721",NULL,"0","57"
58,"Igor","nmccj02",4,"2024-01-31","12885",70,"0","0","12885",NULL,"0","58"
59,"Igor","nmccj03",4,"2024-01-31","22723",70,"0","0","22723",NULL,"0","59"
60,"Igor","nmccj01",4,"2024-02-03","-7879",70,"3361","39212","31333",NULL,"35851","60"
61,"Igor","nmccj02",4,"2024-02-03","-100052",70,"3942","45990","-54062",NULL,"42048","61"
62,"Igor","nmccj03",4,"2024-02-03","44356",70,"3263","38068","82424",NULL,"34805","62"
63,"Igor","nmccj01",5,"2024-02-04","-148891",70,"4457","51998","-96893",NULL,"47541","63"
64,"Igor","nmccj02",5,"2024-02-04","172897",70,"4420","51567","224464",NULL,"47147","64"
65,"Igor","nmccj03",5,"2024-02-04","-354280",70,"4628","53993","-300287",NULL,"49365","65"
66,"Igor","nmccj01",5,"2024-02-05","58193",70,"4707","54915","113108",NULL,"50208","66"
67,"Igor","nmccj02",5,"2024-02-05","17615",70,"6637","77432","95047",NULL,"70795","67"
68,"Igor","nmccj03",5,"2024-02-05","-142843",70,"4725","55125","-87718",NULL,"50400","68"
69,"Igor","nmccj01",5,"2024-02-06","309978",70,"5717","66698","376676",NULL,"60981","69"
70,"Igor","nmccj02",5,"2024-02-06","-213267",70,"6923","80768","-132499",NULL,"73845","70"
71,"Igor","nmccj03",5,"2024-02-06","-693596",70,"8371","97662","-595934",NULL,"89291","71"
72,"Igor","nmccj01",5,"2024-02-08","183624",70,"2178","25410","209034",NULL,"23232","72"
73,"Igor","nmccj02",5,"2024-02-08","204553",70,"2873","33518","238071",NULL,"30645","73"
74,"Igor","nmccj03",5,"2024-02-08","-164797",70,"1962","22890","-141907",NULL,"20928","74"
75,"Igor","nmccj01",5,"2024-02-10","-14875",70,"4332","50540","35665",NULL,"46208","75"
76,"Igor","nmccj02",5,"2024-02-10","-328004",70,"4023","46935","-281069",NULL,"42912","76"
77,"Igor","nmccj03",5,"2024-02-10","-405710",70,"2910","33950","-371760",NULL,"31040","77"
78,"Igor","nmccj01",6,"2024-02-11","150705",70,"4004","46713","197418",NULL,"42709","78"
79,"Igor","nmccj02",6,"2024-02-11","-147423",70,"3941","45978","-101445",NULL,"42037","79"
80,"Igor","nmccj03",6,"2024-02-11","0",70,"0","0","0",NULL,"0","80"
81,"Igor","nmccj01",6,"2024-02-12","105989",70,"3559","41522","147511",NULL,"37963","81"
82,"Igor","nmccj02",6,"2024-02-12","203465",70,"3739","43622","247087",NULL,"39883","82"
83,"Igor","nmccj01",6,"2024-02-13","168593",70,"5598","65310","233903",NULL,"59712","83"
84,"Igor","nmccj02",6,"2024-02-13","31386",70,"4090","47717","79103",NULL,"43627","84"
85,"Igor","nmccj01",6,"2024-02-15","162641",70,"3447","40215","202856",NULL,"36768","85"
86,"Igor","nmccj02",6,"2024-02-15","199130",70,"2870","33483","232613",NULL,"30613","86"
87,"Igor","nmccj01",6,"2024-02-16","62124",70,"1457","16998","79122",NULL,"15541","87"
88,"Igor","nmccj02",6,"2024-02-16","83392",70,"994","11597","94989",NULL,"10603","88"
89,"Igor","nmccj01",6,"2024-02-17","-184185",70,"1469","17138","-167047",NULL,"15669","89"
90,"Igor","nmccj02",6,"2024-02-17","218291",70,"1932","22540","240831",NULL,"20608","90"
91,"Igor","nmccj03",6,"2024-02-17","-16697",70,"1736","20253","3556",NULL,"18517","91"
92,"Igor","nmccj01",7,"2024-02-18","473046",70,"3716","43353","516399",NULL,"39637","92"
93,"Igor","nmccj02",7,"2024-02-18","-88653",70,"4463","52068","-36585",NULL,"47605","93"
94,"Igor","nmccj03",7,"2024-02-18","-40875",70,"3498","40810","-65",NULL,"37312","94"
95,"Igor","nmccj01",7,"2024-02-19","-142710",70,"5673","66185","-76525",NULL,"60512","95"
96,"Igor","nmccj02",7,"2024-02-19","-276247",70,"6264","73080","-203167",NULL,"66816","96"
97,"Igor","nmccj03",7,"2024-02-19","-64052",70,"5578","65077","1025",NULL,"59499","97"
98,"Igor","nmccj03",7,"2024-02-20","-121442",70,"1541","17978","-103464",NULL,"16437","98"
99,"Igor","nmccj02",7,"2024-02-20","-129417",70,"2935","34242","-95175",NULL,"31307","99"
100,"Igor","nmccj01",7,"2024-02-20","-141441",70,"2479","28922","-112519",NULL,"26443","100"
101,"Igor","nmccj01",7,"2024-02-21","177816",70,"5287","61682","239498",NULL,"56395","101"
102,"Igor","nmccj02",7,"2024-02-21","108706",70,"3691","43062","151768",NULL,"39371","102"
103,"Igor","nmccj03",7,"2024-02-21","-185918",70,"4455","51975","-133943",NULL,"47520","103"
104,"Igor","nmccj03",7,"2024-02-22","-487126",70,"6753","78785","-408341",NULL,"72032","104"
105,"Igor","nmccj02",7,"2024-02-22","-56927",70,"7001","81678","24751",NULL,"74677","105"
106,"Igor","nmccj01",7,"2024-02-22","13324",70,"5451","63595","76919",NULL,"58144","106"
107,"Igor","nmccj01",7,"2024-02-23","-474849",70,"7979","93088","-381761",NULL,"85109","107"
108,"Igor","nmccj02",7,"2024-02-23","-404261",70,"8187","95515","-308746",NULL,"87328","108"
109,"Igor","nmccj03",7,"2024-02-23","170971",70,"8128","94827","265798",NULL,"86699","109"
110,"Igor","nmccj01",8,"2024-02-28","-220299",70,"3517","41032","-179267",NULL,"37515","110"
111,"Igor","nmccj02",8,"2024-02-28","413477",70,"3900","45500","458977",NULL,"41600","111"
113,"Igor","nmccj01",9,"2024-03-03","15436",70,"2963","34568","50004",NULL,"31605","113"
114,"Igor","nmccj02",9,"2024-03-03","-118072",70,"2164","25247","-92825",NULL,"23083","114"
116,"Igor","nmccj03",9,"2024-03-03","-31482",70,"1936","22587","-8895",NULL,"20651","116"
117,"Igor","nmccj03",9,"2024-03-04","521135",70,"4218","49210","570345",NULL,"44992","117"
118,"Igor","nmccj01",9,"2024-03-04","-47953",70,"3049","35572","-12381",NULL,"32523","118"
119,"Igor","nmccj02",9,"2024-03-04","-184788",70,"3069","35805","-148983",NULL,"32736","119"
120,"Igor","nmccj01",9,"2024-03-05","91132",70,"4303","50202","141334",NULL,"45899","120"
121,"Igor","nmccj02",9,"2024-03-05","-109555",70,"3417","39865","-69690",NULL,"36448","121"
122,"Igor","nmccj03",9,"2024-03-05","13820",70,"3772","44007","57827",NULL,"40235","122"
123,"Igor","nmccj01",9,"2024-03-07","-277483",70,"3077","35898","-241585",NULL,"32821","123"
124,"Igor","nmccj02",9,"2024-03-07","-372448",70,"3214","37497","-334951",NULL,"34283","124"
125,"Igor","nmccj03",9,"2024-03-07","-54832",70,"2210","25783","-29049",NULL,"23573","125"
126,"Igor","nmccj01",9,"2024-03-09","210420",70,"2938","34277","244697",NULL,"31339","126"
127,"Igor","nmccj02",9,"2024-03-09","-147420",70,"2467","28782","-118638",NULL,"26315","127"
128,"Igor","nmccj03",9,"2024-03-09","74810",70,"2053","23952","98762",NULL,"21899","128"
129,"Igor","nmccj02",10,"2024-03-11","311659",70,"2812","32807","344466",NULL,"29995","129"
130,"Igor","nmccj03",10,"2024-03-11","121248",70,"2167","25282","146530",NULL,"23115","130"
131,"Igor","nmccj01",10,"2024-03-11","-198803",70,"1516","17687","-181116",NULL,"16171","131"
132,"Igor","nmccj01",10,"2024-03-13","-134612",70,"3204","37380","-97232",NULL,"34176","132"
133,"Igor","nmccj02",10,"2024-03-13","49800",70,"2284","26647","76447",NULL,"24363","133"
134,"Igor","nmccj03",10,"2024-03-13","166674",70,"2805","32725","199399",NULL,"29920","134"
135,"Igor","nmccj01",10,"2024-03-15","148074",70,"2199","25655","173729",NULL,"23456","135"
136,"Igor","nmccj02",10,"2024-03-15","-157245",70,"2771","32328","-124917",NULL,"29557","136"
137,"Igor","nmccj03",10,"2024-03-15","231185",70,"2898","33810","264995",NULL,"30912","137"
138,"Igor","nmccj01",10,"2024-03-16","229183",70,"1858","21677","250860",NULL,"19819","138"
139,"Igor","nmccj02",10,"2024-03-16","-123788",70,"1569","18305","-105483",NULL,"16736","139"
140,"Igor","nmccj03",10,"2024-03-16","-480812",70,"4069","47472","-433340",NULL,"43403","140"
141,"Igor","nmccj01",11,"2024-03-17","138378",70,"1789","20872","159250",NULL,"19083","141"
142,"Igor","nmccj03",11,"2024-03-17","-254395",70,"2399","27988","-226407",NULL,"25589","142"
143,"Igor","nmccj02",11,"2024-03-17","-200804",70,"1839","21455","-179349",NULL,"19616","143"
144,"Igor","nmccj01",11,"2024-03-18","55476",70,"2254","26297","81773",NULL,"24043","144"
145,"Igor","nmccj02",11,"2024-03-18","-392757",70,"1831","21362","-371395",NULL,"19531","145"
146,"Igor","nmccj03",11,"2024-03-18","-170292",70,"1402","16357","-153935",NULL,"14955","146"
147,"Igor","nmccj01",11,"2024-03-21","195714",70,"2507","29248","224962",NULL,"26741","147"
148,"Igor","nmccj02",11,"2024-03-21","38526",70,"1877","21898","60424",NULL,"20021","148"
149,"Igor","nmccj03",11,"2024-03-21","88555",70,"1767","20615","109170",NULL,"18848","149"
150,"Igor","nmccj01",12,"2024-03-25","182127",70,"4605","53725","235852",NULL,"49120","150"
151,"Igor","nmccj02",12,"2024-03-25","-152116",70,"1426","16637","-135479",NULL,"15211","151"
152,"Igor","nmccj03",12,"2024-03-25","-483142",70,"6342","73990","-409152",NULL,"67648","152"
153,"Igor","nmccj01",14,"2024-04-10","252381",70,"2000","23333","275714",NULL,"21333","153"
154,"Igor","nmccj03",14,"2024-04-10","-114403",70,"1000","11667","-102736",NULL,"10667","154"
155,"Igor","nmccj01",14,"2024-04-11","-142182",70,"1010","11783","-130399",NULL,"10773","155"
156,"Igor","nmccj03",14,"2024-04-11","-120377",70,"25124","293113","172736",NULL,"267989","156"
157,"Igor","nmccj01",14,"2024-04-13","154953",70,"2710","31617","186570",NULL,"28907","157"
158,"Igor","nmccj03",14,"2024-04-13","-58693",70,"1536","17920","-40773",NULL,"16384","158"
159,"Igor","nmccj01",15,"2024-04-14","114185",70,"2252","26273","140458",NULL,"24021","159"
160,"Igor","nmccj03",15,"2024-04-14","61620",70,"1435","16742","78362",NULL,"15307","160"
161,"Igor","nmccj01",15,"2024-04-15","-176831",70,"1955","22808","-154023",NULL,"20853","161"
162,"Igor","nmccj03",15,"2024-04-15","35878",70,"2019","23555","59433",NULL,"21536","162"
163,"Igor","nmccj01",15,"2024-04-16","125434",70,"2415","28175","153609",NULL,"25760","163"
164,"Igor","nmccj03",15,"2024-04-16","34718",70,"1315","15342","50060",NULL,"14027","164"
165,"Igor","nmccj01",15,"2024-04-17","126758",70,"2401","28012","154770",NULL,"25611","165"
166,"Igor","nmccj03",15,"2024-04-17","17336",70,"1439","16788","34124",NULL,"15349","166"
167,"Igor","nmccj01",15,"2024-04-18","210824",70,"1685","19658","230482",NULL,"17973","167"
168,"Igor","nmccj03",15,"2024-04-18","35345",70,"873","10185","45530",NULL,"9312","168"
169,"Igor","nmccj01",15,"2024-04-19","82233",70,"2156","25153","107386",NULL,"22997","169"
170,"Igor","nmccj03",15,"2024-04-19","57984",70,"1868","21793","79777",NULL,"19925","170"
171,"Igor","nmccj01",15,"2024-04-20","-8135",70,"2214","25830","17695",NULL,"23616","171"
172,"Igor","nmccj03",15,"2024-04-20","364285",70,"2822","32923","397208",NULL,"30101","172"
173,"Igor","nmccj01",16,"2024-04-21","-76462",70,"2900","33833","-42629",NULL,"30933","173"
174,"Igor","nmccj03",16,"2024-04-21","119878",70,"2312","26973","146851",NULL,"24661","174"
177,"Igor","nmccj01",16,"2024-04-22","-149450",70,"2783","32468","-116982",NULL,"29685","177"
178,"Igor","nmccj03",16,"2024-04-22","113909",70,"2311","26962","140871",NULL,"24651","178"
179,"Igor","nmccj02",16,"2024-04-22","0",70,NULL,NULL,NULL,NULL,NULL,"179"
180,"Igor","nmccj01",16,"2024-04-23","41689",70,"3628","42327","84016",NULL,"38699","180"
181,"Igor","nmccj03",16,"2024-04-23","63190",70,"2279","26588","89778",NULL,"24309","181"
182,"Igor","nmccj01",16,"2024-04-25","157075",70,"690","8050","165125",NULL,"7360","182"
183,"Igor","nmccj03",16,"2024-04-25","247129",70,"1051","12262","259391",NULL,"11211","183"
184,"Igor","nmccj01",16,"2024-04-27","-130839",70,"1699","19822","-111017",NULL,"18123","184"
185,"Igor","nmccj03",16,"2024-04-27","-78970",70,"1875","21875","-57095",NULL,"20000","185"
186,"Igor","nmccj01",17,"2024-04-29","-134715",70,"3306","38570","-96145",NULL,"35264","186"
187,"Igor","nmccj03",17,"2024-04-29","-91524",70,"3460","40367","-51157",NULL,"36907","187"
188,"Igor","nmccj01",17,"2024-04-30","502039",70,"2719","31722","533761",NULL,"29003","188"
189,"Igor","nmccj03",17,"2024-04-30","44731",70,"1992","23240","67971",NULL,"21248","189"
190,"Igor","nmccj01",17,"2024-05-01","31077",70,"2948","34393","65470",NULL,"31445","190"
191,"Igor","nmccj03",17,"2024-05-01","-26399",70,"1680","19600","-6799",NULL,"17920","191"
192,"Igor","nmccj01",17,"2024-05-03","-610279",70,"4715","55008","-555271",NULL,"50293","192"
193,"Igor","nmccj03",17,"2024-05-03","238865",70,"4311","50295","289160",NULL,"45984","193"
194,"Igor","nmccj01",17,"2024-05-04","142610",70,"2199","25655","168265",NULL,"23456","194"
195,"Igor","nmccj03",17,"2024-05-04","43490",70,"2487","29015","72505",NULL,"26528","195"
196,"Igor","nmccj01",18,"2024-05-06","37393",70,"4177","48732","86125",NULL,"44555","196"
197,"Igor","nmccj03",18,"2024-05-06","-117789",70,"3297","38465","-79324",NULL,"35168","197"
198,"Igor","nmccj01",19,"2024-05-16","109379",70,"2038","23777","133156",NULL,"21739","198"
199,"Igor","nmccj03",19,"2024-05-16","73046",70,"1615","18842","91888",NULL,"17227","199"
200,"Igor","nmccj01",19,"2024-05-17","80651",70,"4299","50155","130806",NULL,"45856","200"
201,"Igor","nmccj03",19,"2024-05-17","-62811",70,"5248","61227","-1584",NULL,"55979","201"
202,"Igor","nmccj01",19,"2024-05-18","-355069",70,"5713","66652","-288417",NULL,"60939","202"
203,"Igor","nmccj03",19,"2024-05-18","69250",70,"4971","57995","127245",NULL,"53024","203"
204,"Igor","nmccj01",20,"2024-05-19","243031",70,"3252","37940","280971",NULL,"34688","204"
205,"Igor","nmccj03",20,"2024-05-19","-151187",70,"2835","33075","-118112",NULL,"30240","205"
206,"Igor","nmccj01",20,"2024-05-20","138781",70,"815","9508","148289",NULL,"8693","206"
207,"Igor","nmccj03",20,"2024-05-20","17463",70,"915","10675","28138",NULL,"9760","207"
208,"Igor","nmccj01",20,"2024-05-21","-389010",70,"3000","35000","-354010",NULL,"32000","208"
209,"Igor","nmccj03",20,"2024-05-21","-275398",70,"3000","35000","-240398",NULL,"32000","209"
210,"Igor","nmccj01",20,"2024-05-24","-10571",70,"4861","56712","46141",NULL,"51851","210"
211,"Igor","nmccj03",20,"2024-05-24","101877",70,"3678","42910","144787",NULL,"39232","211"
212,"Igor","nmccj01",20,"2024-05-25","199763",70,"2859","33355","233118",NULL,"30496","212"
213,"Igor","nmccj03",20,"2024-05-25","150928",70,"2320","27067","177995",NULL,"24747","213"
214,"Igor","nmccj01",21,"2024-05-26","-205303",70,"4441","51812","-153491",NULL,"47371","214"
215,"Igor","nmccj03",21,"2024-05-26","51627",70,"4329","50505","102132",NULL,"46176","215"
216,"Igor","nmccj01",21,"2024-05-27","138330",70,"8855","103308","241638",NULL,"94453","216"
217,"Igor","nmccj03",21,"2024-05-27","-754687",70,"9214","107497","-647190",NULL,"98283","217"
218,"Igor","nmccj01",21,"2024-05-28","273257",70,"1906","22237","295494",NULL,"20331","218"
219,"Igor","nmccj03",21,"2024-05-28","-64350",70,"2359","27522","-36828",NULL,"25163","219"
220,"Igor","nmccj01",21,"2024-05-29","144097",70,"1586","18503","162600",NULL,"16917","220"
221,"Igor","nmccj03",21,"2024-05-29","172090",70,"1993","23252","195342",NULL,"21259","221"
222,"Igor","nmccj01",21,"2024-05-30","287841",70,"4567","53282","341123",NULL,"48715","222"
223,"Igor","nmccj03",21,"2024-05-30","41075",70,"3407","39748","80823",NULL,"36341","223"
224,"Igor","nmccj01",21,"2024-05-31","89450",70,"2933","34218","123668",NULL,"31285","224"
225,"Igor","nmccj03",21,"2024-05-31","-13784",70,"4311","50295","36511",NULL,"45984","225"
226,"Igor","nmccj01",21,"2024-06-01","-81887",70,"3414","39830","-42057",NULL,"36416","226"
227,"Igor","nmccj03",21,"2024-06-01","-56424",70,"2972","34673","-21751",NULL,"31701","227"
228,"Igor","nmccj01",22,"2024-06-02","212738",70,"3613","42152","254890",NULL,"38539","228"
229,"Igor","nmccj03",22,"2024-06-02","-270439",70,"2392","27907","-242532",NULL,"25515","229"
230,"Igor","nmccj01",22,"2024-06-03","-11680",70,"2935","34242","22562",NULL,"31307","230"
231,"Igor","nmccj03",22,"2024-06-03","-120309",70,"3159","36855","-83454",NULL,"33696","231"
232,"Igor","nmccj01",22,"2024-06-04","-181804",70,"7651","89262","-92542",NULL,"81611","232"
233,"Igor","nmccj03",22,"2024-06-04","-312417",70,"5765","67258","-245159",NULL,"61493","233"
234,"Igor","nmccj01",22,"2024-06-05","270705",70,"1300","15167","285872",NULL,"13867","234"
235,"Igor","nmccj03",22,"2024-06-05","136371",70,"845","9858","146229",NULL,"9013","235"
236,"Igor","nmccj01",22,"2024-06-06","-106242",70,"2230","26017","-80225",NULL,"23787","236"
237,"Igor","nmccj03",22,"2024-06-06","-10932",70,"2286","26670","15738",NULL,"24384","237"
238,"Igor","nmccj01",22,"2024-06-07","257532",70,"2239","26122","283654",NULL,"23883","238"
239,"Igor","nmccj03",22,"2024-06-07","-15787",70,"1510","17617","1830",NULL,"16107","239"
240,"Igor","nmccj01",22,"2024-06-08","-43971",70,"3481","40612","-3359",NULL,"37131","240"
241,"Igor","nmccj03",22,"2024-06-08","-199769",70,"3806","44403","-155366",NULL,"40597","241"
242,"Igor","nmccj01",23,"2024-06-09","14612",70,"521","6078","20690",NULL,"5557","242"
243,"Igor","nmccj03",23,"2024-06-09","202078",70,"1519","17722","219800",NULL,"16203","243"
244,"Igor","nmccj01",23,"2024-06-10","-64348",70,"4873","56852","-7496",NULL,"51979","244"
245,"Igor","nmccj03",23,"2024-06-10","-388309",70,"5042","58823","-329486",NULL,"53781","245"
246,"Igor","nmccj01",23,"2024-06-11","-291258",70,"4035","47075","-244183",NULL,"43040","246"
247,"Igor","nmccj03",23,"2024-06-11","397847",70,"3981","46445","444292",NULL,"42464","247"
248,"Igor","nmccj01",23,"2024-06-12","499189",70,"4450","51917","551106",NULL,"47467","248"
249,"Igor","nmccj03",23,"2024-06-12","-151284",70,"3233","37718","-113566",NULL,"34485","249"
250,"Igor","nmccj01",23,"2024-06-13","-121375",70,"3039","35455","-85920",NULL,"32416","250"
251,"Igor","nmccj03",23,"2024-06-13","88794",70,"4059","47355","136149",NULL,"43296","251"
252,"Igor","nmccj01",23,"2024-06-14","65432",70,"782","9123","74555",NULL,"8341","252"
253,"Igor","nmccj03",23,"2024-06-14","153740",70,"1171","13662","167402",NULL,"12491","253"
254,"Igor","nmccj01",24,"2024-06-17","176085",70,"1066","12437","188522",NULL,"11371","254"
255,"Igor","nmccj03",24,"2024-06-17","122301",70,"624","7280","129581",NULL,"6656","255"
256,"Igor","nmccj01",24,"2024-06-18","162814",70,"2147","25048","187862",NULL,"22901","256"
257,"Igor","nmccj03",24,"2024-06-18","190416",70,"2139","24955","215371",NULL,"22816","257"
258,"Igor","nmccj01",24,"2024-06-19","-318611",70,"3374","39363","-279248",NULL,"35989","258"
259,"Igor","nmccj03",24,"2024-06-19","15570",70,"2926","34137","49707",NULL,"31211","259"
260,"Igor","nmccj01",24,"2024-06-20","-244135",70,"5006","58403","-185732",NULL,"53397","260"
261,"Igor","nmccj03",24,"2024-06-20","9554",70,"7502","87523","97077",NULL,"80021","261"
262,"Igor","nmccj01",24,"2024-06-21","123132",70,"6525","76125","199257",NULL,"69600","262"
263,"Igor","nmccj03",24,"2024-06-21","-539692",70,"6228","72660","-467032",NULL,"66432","263"
264,"Igor","nmccj01",24,"2024-06-22","77365",70,"1862","21723","99088",NULL,"19861","264"
265,"Igor","nmccj03",24,"2024-06-22","74668",70,"2298","26810","101478",NULL,"24512","265"
266,"Igor","nmccj01",25,"2024-06-23","81117",70,"6805","79392","160509",NULL,"72587","266"
267,"Igor","nmccj03",25,"2024-06-23","-138493",70,"7757","90498","-47995",NULL,"82741","267"
268,"Igor","nmccj01",25,"2024-06-25","150604",70,"4344","50680","201284",NULL,"46336","268"
269,"Igor","nmccj03",25,"2024-06-25","-103115",70,"3669","42805","-60310",NULL,"39136","269"
270,"Igor","nmccj01",25,"2024-06-26","256209",70,"2430","28350","284559",NULL,"25920","270"
271,"Igor","nmccj03",25,"2024-06-26","109778",70,"1686","19670","129448",NULL,"17984","271"
272,"Igor","nmccj01",25,"2024-06-27","-70269",70,"7268","84793","14524",NULL,"77525","272"
273,"Igor","nmccj03",25,"2024-06-27","6969",70,"3667","42782","49751",NULL,"39115","273"
274,"Igor","nmccj01",25,"2024-06-28","29213",70,"2107","24582","53795",NULL,"22475","274"
275,"Igor","nmccj03",25,"2024-06-28","50753",70,"1705","19892","70645",NULL,"18187","275"
276,"Igor","nmccj01",26,"2024-07-03","-174433",70,"1805","21058","-153375",NULL,"19253","276"
277,"Igor","nmccj03",26,"2024-07-03","138653",70,"1651","19262","157915",NULL,"17611","277"
278,"Igor","nmccj01",26,"2024-07-05","142946",70,"2213","25818","168764",NULL,"23605","278"
279,"Igor","nmccj03",26,"2024-07-05","175549",70,"2089","24372","199921",NULL,"22283","279"
280,"Igor","nmccj01",27,"2024-07-07","206521",70,"4548","53060","259581",NULL,"48512","280"
281,"Igor","nmccj03",27,"2024-07-07","-126339",70,"3930","45850","-80489",NULL,"41920","281"
282,"Igor","nmccj01",27,"2024-07-08","191029",70,"5436","63420","254449",NULL,"57984","282"
283,"Igor","nmccj03",27,"2024-07-08","1018",70,"3611","42128","43146",NULL,"38517","283"
284,"Igor","nmccj01",27,"2024-07-09","156174",70,"2132","24873","181047",NULL,"22741","284"
285,"Igor","nmccj03",27,"2024-07-09","159077",70,"1790","20883","179960",NULL,"19093","285"
286,"Igor","nmccj01",27,"2024-07-10","300624",70,"2853","33285","333909",NULL,"30432","286"
287,"Igor","nmccj03",27,"2024-07-10","-35811",70,"3886","45337","9526",NULL,"41451","287"
288,"Igor","nmccj01",27,"2024-07-11","52533",70,"3923","45768","98301",NULL,"41845","288"
289,"Igor","nmccj03",27,"2024-07-11","-13893",70,"3438","40110","26217",NULL,"36672","289"
290,"Igor","nmccj01",27,"2024-07-12","-57412",70,"9488","110693","53281",NULL,"101205","290"
291,"Igor","nmccj03",27,"2024-07-12","85024",70,"9172","107007","192031",NULL,"97835","291"
292,"Igor","nmccj03",27,"2024-07-13","-106501",70,"9052","105607","-894",NULL,"96555","292"
293,"Igor","nmccj01",27,"2024-07-13","-555538",70,"6963","81235","-474303",NULL,"74272","293"
294,"Igor","nmccj01",28,"2024-07-14","345390",70,"7678","89577","434967",NULL,"81899","294"
295,"Igor","nmccj03",28,"2024-07-14","-655844",70,"9014","105163","-550681",NULL,"96149","295"
296,"Igor","nmccj01",28,"2024-07-15","-362350",70,"3459","40355","-321995",NULL,"36896","296"
297,"Igor","nmccj03",28,"2024-07-15","51886",70,"3243","37835","89721",NULL,"34592","297"
298,"Igor","nmccj01",28,"2024-07-16","118275",70,"4195","48942","167217",NULL,"44747","298"
299,"Igor","nmccj03",28,"2024-07-16","133926",70,"4624","53947","187873",NULL,"49323","299"
300,"Igor","nmccj01",28,"2024-07-17","53433",70,"5361","62545","115978",NULL,"57184","300"
301,"Igor","nmccj03",28,"2024-07-17","-193378",70,"7278","84910","-108468",NULL,"77632","301"
302,"Igor","nmccj01",28,"2024-07-18","346072",70,"3444","40180","386252",NULL,"36736","302"
303,"Igor","nmccj03",28,"2024-07-18","86841",70,"4046","47203","134044",NULL,"43157","303"
304,"Igor","nmccj01",28,"2024-07-19","64067",70,"2121","24745","88812",NULL,"22624","304"
305,"Igor","nmccj03",28,"2024-07-19","484785",70,"2507","29248","514033",NULL,"26741","305"
306,"Igor","nmccj01",28,"2024-07-20","206848",70,"3328","38827","245675",NULL,"35499","306"
307,"Igor","nmccj03",28,"2024-07-20","32208",70,"3586","41837","74045",NULL,"38251","307"
308,"Igor","nmccj01",29,"2024-07-21","55755",70,"1138","13277","69032",NULL,"12139","308"
309,"Igor","nmccj03",29,"2024-07-21","78177",70,"1001","11678","89855",NULL,"10677","309"
310,"Igor","nmccj01",29,"2024-07-22","-51553",70,"2250","26250","-25303",NULL,"24000","310"
311,"Igor","nmccj03",29,"2024-07-22","246925",70,"3324","38780","285705",NULL,"35456","311"
312,"Igor","nmccj01",29,"2024-07-23","71472",70,"3779","44088","115560",NULL,"40309","312"
313,"Igor","nmccj03",29,"2024-07-23","70691",70,"2439","28455","99146",NULL,"26016","313"
314,"Igor","nmccj01",29,"2024-07-24","-214659",70,"3894","45430","-169229",NULL,"41536","314"
315,"Igor","nmccj03",29,"2024-07-24","-20956",70,"2293","26752","5796",NULL,"24459","315"
316,"Igor","nmccj01",29,"2024-07-25","-20248",70,"7625","88958","68710",NULL,"81333","316"
317,"Igor","nmccj03",29,"2024-07-25","-392622",70,"9767","113948","-278674",NULL,"104181","317"
318,"Igor","nmccj01",29,"2024-07-26","230676",70,"6074","70863","301539",NULL,"64789","318"
319,"Igor","nmccj03",29,"2024-07-26","-235637",70,"4321","50412","-185225",NULL,"46091","319"
320,"Igor","nmccj01",30,"2024-07-29","-135989",70,"7897","92132","-43857",NULL,"84235","320"
321,"Igor","nmccj03",30,"2024-07-29","-398518",70,"7832","91373","-307145",NULL,"83541","321"
322,"Igor","nmccj01",30,"2024-07-30","486841",70,"4950","57750","544591",NULL,"52800","322"
323,"Igor","nmccj03",30,"2024-07-30","24330",70,"5355","62475","86805",NULL,"57120","323"
324,"Igor","nmccj01",30,"2024-07-31","-381482",70,"7846","91537","-289945",NULL,"83691","324"
325,"Igor","nmccj03",30,"2024-07-31","212749",70,"6305","73558","286307",NULL,"67253","325"
326,"Igor","nmccj01",30,"2024-08-01","-28048",70,"6913","80652","52604",NULL,"73739","326"
327,"Igor","nmccj03",30,"2024-08-01","268456",70,"5168","60293","328749",NULL,"55125","327"
328,"Igor","nmccj01",30,"2024-08-02","-214791",70,"8083","94302","-120489",NULL,"86219","328"
329,"Igor","nmccj03",30,"2024-08-02","366180",70,"5468","63793","429973",NULL,"58325","329"
330,"Igor","nmccj01",31,"2024-08-05","-875074",70,"22893","267085","-607989",NULL,"244192","330"
331,"Igor","nmccj03",31,"2024-08-05","-271777",70,"12000","140000","-131777",NULL,"128000","331"
332,"Igor","nmccj01",31,"2024-08-06","-184864",70,"5377","62732","-122132",NULL,"57355","332"
333,"Igor","nmccj03",31,"2024-08-06","230356",70,"8984","104813","335169",NULL,"95829","333"
334,"Igor","nmccj01",31,"2024-08-07","-326697",70,"8119","94722","-231975",NULL,"86603","334"
335,"Igor","nmccj03",31,"2024-08-07","44058",70,"8571","99995","144053",NULL,"91424","335"
336,"Igor","nmccj01",31,"2024-08-08","-224393",70,"7300","85167","-139226",NULL,"77867","336"
337,"Igor","nmccj03",31,"2024-08-08","265946",70,"7915","92342","358288",NULL,"84427","337"
338,"Igor","nmccj01",31,"2024-08-09","-291197",70,"4020","46900","-244297",NULL,"42880","338"
339,"Igor","nmccj03",31,"2024-08-09","218656",70,"3679","42922","261578",NULL,"39243","339"
340,"Igor","nmccj01",31,"2024-08-10","-222506",70,"5583","65135","-157371",NULL,"59552","340"
341,"Igor","nmccj03",31,"2024-08-10","186002",70,"5351","62428","248430",NULL,"57077","341"
342,"Igor","nmccj01",32,"2024-08-12","-328119",70,"5362","62557","-265562",NULL,"57195","342"
343,"Igor","nmccj03",32,"2024-08-12","157240",70,"4661","54378","211618",NULL,"49717","343"
344,"Igor","nmccj01",32,"2024-08-13","-268491",70,"12682","147957","-120534",NULL,"135275","344"
345,"Igor","nmccj03",32,"2024-08-13","-57587",70,"9446","110203","52616",NULL,"100757","345"
346,"Igor","nmccj01",32,"2024-08-14","-370325",70,"2194","25597","-344728",NULL,"23403","346"
347,"Igor","nmccj03",32,"2024-08-14","-459186",70,"4300","50167","-409019",NULL,"45867","347"
348,"Igor","nmccj01",32,"2024-08-15","13341",70,"3843","44835","58176",NULL,"40992","348"
349,"Igor","nmccj01",32,"2024-08-16","281395",70,"1487","17348","298743",NULL,"15861","349"
350,"Igor","nmccj01",33,"2024-08-19","399593",70,"3679","42922","442515",NULL,"39243","350"
383,"Igor","nmccj01",33,"2024-08-20","-142915",70,"5359","62522","-80393",NULL,"57163","383"
384,"Igor","nmccj01",33,"2024-08-21","-74799",70,"2267","26448","-48351",NULL,"24181","384"
417,"Igor","nmccj01",33,"2024-08-22","504290",70,"4681","54612","558902",NULL,"49931","417"
418,"Igor","nmccj01",33,"2024-08-23","123066",70,"3907","45582","168648",NULL,"41675","418"
419,"Igor","nmccj03",33,"2024-08-23","-90230",70,"2274","26530","-63700",NULL,"24256","419"
420,"Igor","nmccj01",34,"2024-08-26","98539",70,"4214","49163","147702",NULL,"44949","420"
421,"Igor","nmccj03",34,"2024-08-26","139529",70,"4240","49467","188996",NULL,"45227","421"
422,"Igor","nmccj01",34,"2024-08-27","-233602",70,"4192","48907","-184695",NULL,"44715","422"
423,"Igor","nmccj03",34,"2024-08-27","83360",70,"4199","48988","132348",NULL,"44789","423"
424,"Igor","nmccj01",34,"2024-08-28","91400",70,"5583","65135","156535",NULL,"59552","424"
425,"Igor","nmccj03",34,"2024-08-28","-113807",70,"4262","49723","-64084",NULL,"45461","425"
426,"Igor","nmccj01",34,"2024-08-29","122124",70,"4929","57505","179629",NULL,"52576","426"
427,"Igor","nmccj03",34,"2024-08-29","174200",70,"4075","47542","221742",NULL,"43467","427"
428,"Igor","nmccj01",34,"2024-08-30","-246270",70,"6231","72695","-173575",NULL,"66464","428"
429,"Igor","nmccj03",34,"2024-08-30","-518809",70,"7137","83265","-435544",NULL,"76128","429"
430,"Igor","nmccj01",34,"2024-08-31","12222",70,"6397","74632","86854",NULL,"68235","430"
431,"Igor","nmccj03",34,"2024-08-31","-242097",70,"4253","49618","-192479",NULL,"45365","431"
432,"Igor","nmccj01",35,"2024-09-01","335795",70,"4521","52745","388540",NULL,"48224","432"
433,"Igor","nmccj03",35,"2024-09-01","-54130",70,"2382","27790","-26340",NULL,"25408","433"
466,"Igor","nmccj01",35,"2024-09-02","-324426",70,"8255","96308","-228118",NULL,"88053","466"
467,"Igor","nmccj01",35,"2024-09-03","302486",70,"3527","41148","343634",NULL,"37621","467"
468,"Igor","nmccj01",35,"2024-09-04","84015",70,"5399","62988","147003",NULL,"57589","468"
469,"Igor","nmccj01",35,"2024-09-05","-654606",70,"8088","94370","-560236",NULL,"86282","469"
470,"Igor","nmccj01",39,"2024-09-29","21721",70,"3740","43633","65354",NULL,"39893","470"
471,"Igor","nmccj01",39,"2024-09-30","-331777",70,"7055","82308","-249469",NULL,"75253","471"
472,"Igor","nmccj01",39,"2024-10-01","119111",70,"3096","36120","155231",NULL,"33024","472"
473,"Igor","nmccj01",39,"2024-10-02","-21911",70,"6543","76335","54424",NULL,"69792","473"
474,"Igor","nmccj01",39,"2024-10-03","150314",70,"5343","62335","212649",NULL,"56992","474"
475,"Igor","nmccj01",39,"2024-10-04","245815",70,"5257","61332","307147",NULL,"56075","475"
476,"Igor","nmccj01",39,"2024-10-05","14805",70,"3719","43388","58193",NULL,"39669","476"
477,"Igor","nmccj01",40,"2024-10-07","-60497",70,"5240","61133","636",NULL,"55893","477"
478,"Igor","nmccj01",40,"2024-10-08","65102",70,"4145","48358","113460",NULL,"44213","478"
479,"Igor","nmccj01",40,"2024-10-09","199011",70,"5860","68367","267378",NULL,"62507","479"
480,"Igor","nmccj01",40,"2024-10-10","242066",70,"3743","43668","285734",NULL,"39925","480"
481,"Igor","nmccj01",40,"2024-10-11","-64739",70,"4112","47973","-16766",NULL,"43861","481"
482,"Igor","nmccj01",40,"2024-10-12","-132169",70,"5451","63595","-68574",NULL,"58144","482"
483,"Igor","nmccj01",41,"2024-10-14","-876557",70,"8898","103810","-772747",NULL,"94912","483"
484,"Igor","nmccj01",41,"2024-10-15","80108",70,"3447","40215","120323",NULL,"36768","484"
485,"Igor","nmccj01",41,"2024-10-16","230253",70,"2270","26483","256736",NULL,"24213","485"
486,"Igor","nmccj01",41,"2024-10-17","-569542",70,"9124","106447","-463095",NULL,"97323","486"
487,"Igor","nmccj01",42,"2024-10-25","138523",70,"3622","42257","180780",NULL,"38635","487"
488,"Igor","nmccj01",43,"2024-10-28","71641",70,"5720","66733","138374",NULL,"61013","488"
489,"Igor","nmccj01",43,"2024-10-29","-575113",70,"10674","124530","-450583",NULL,"113856","489"
490,"Igor","nmccj03",43,"2024-11-02","296814",70,"3346","39037","335851",NULL,"35691","490"
491,"Igor","nmccj03",44,"2024-11-04","15860",70,"3624","42280","58140",NULL,"38656","491"
492,"Igor","nmccj03",44,"2024-11-05","-112078",70,"6757","78832","-33246",NULL,"72075","492"
493,"Igor","nmccj03",44,"2024-11-06","504378",70,"5144","60013","564391",NULL,"54869","493"
494,"Igor","nmccj01",44,"2024-11-07","298211",70,"1539","17955","316166",NULL,"16416","494"
495,"Igor","nmccj03",44,"2024-11-07","525120",70,"4359","50855","575975",NULL,"46496","495"
496,"Igor","nmccj01",44,"2024-11-08","-157970",70,"6899","80488","-77482",NULL,"73589","496"
497,"Igor","nmccj03",44,"2024-11-08","-449007",70,"6815","79508","-369499",NULL,"72693","497"
498,"Igor","nmccj01",44,"2024-11-09","128335",70,"6209","72438","200773",NULL,"66229","498"
499,"Igor","nmccj03",44,"2024-11-09","-581755",70,"9003","105035","-476720",NULL,"96032","499"
500,"Igor","nmccj01",45,"2024-11-11","-836393",70,NULL,NULL,NULL,NULL,NULL,"500"
501,"Igor","nmccj03",45,"2024-11-11","-73941",70,NULL,NULL,NULL,NULL,NULL,"501"
